6  7
5039 5127 5238 5259 5248 5310 5299 
5150 5392 5410 5401 5320 5820 5321 
5290 5560 5490 5421 5530 5831 5210 
5110 5429 5430 5411 5459 5630 5319 
4920 5129 4921 5821 4722 4921 5129 
5023 5129 4822 4872 4794 4862 4245